NO ../textures/a.png
SO ../textures/b.png
WE ../textures/c.png
EA ../textures/d.png
F 40,40,40
C 135,206,235
M 5 3

1111111111111111111111111111111111111
10000000000000000000000000000000000001
1000000000000000000010000000000000000111
10000000000000000000100000000000000000001
1000000000000000E000D00000000000000000001
10000000000000000000100000000000000000001
10000000000000000000100000000000000000001
10000000011111100111111111111111100000001
10000000000000000000000000000000000000001
1111111100000000000111111111111111111111
        11111101111
        10000000001
        10000000001
        1111101111111111111111111
        1000000000110000000000001
        1011000001110000000000001
        1001000000000000000000001
111111111011000001110000000000001
100000000011000001110111111111111
11110111111111011100000010001
11110111111110111010100100111
11000000110101011100000010001
10000000000000001100000010001
10000000000000001101010010001
11000001110101011111011110011
11110111 1110101 101111010001
11111111 1111111 111111111111