NO textures/mur/a.png
SO textures/mur/b.png
WE textures/mur/c.png
EA textures/mur/d.png
F 40,40,40
C 135,206,235

1111111111111
1000000000001
1000000S00001
1000000000001
100000001111111
1000000000001
1000000000001
1000000000001
1111111111111 