NO ../textures/a.png
SO ../textures/b.png
WE ../textures/c.png
EA ../textures/d.png
F 40,40,40
C 135,206,235
M 10 10

11111111111
10000000001
10000000001
100000S0001
10000000011
10000000001
1000000111
10001000001
10001000001
11111111111
