
                 NO                    textures/no.png


                                        SO                                           textures/so.png
                                WE                                textures/we.png


                               EA                      textures/ea.png
F           34,    90  ,     143           

					C      					    0,   222 ,   222   

        11111111111
        10000000001
        10000000001
        1111111111111111111111111
        1000000000110000000000001
        1011000001110000000000001
        1001000000D00000000000001
111111111011000001110000000000001
100000000011000001110111111111111
11110111111111011100000010001
11110111111110000010100100111
11000000110101010100000010001
1000000000000000D100000N10001
10000000000000001101010010001
11000001110101011110111100111
11110111 1110101 101111010001
11111111 1111111 111111111111