
                 NO                    ./path_to_the_north_texture.png


                                        SOa.png
                                WE                                ./path_to_the_west_texture.png                        
								
                               EA                      ./path_to_the_east_texture.png

F           255,1,13
					C      					    2,22,223

                                         11111111111
                                         10000000001
                                         10000000001
                                         1111111111111111111111111
                                         1000000000110000000000001
                                         1011000001110000000000001
1111111111111111111111111                1000000001111111111110001
1001000001000011111111111                1111111111111111111111111
1111000001011111111111001111111111
1111100001011000001110000000000001
1000000000110000011101111111111111
11110111111111011100000010001
11110111111110111010100100111
110000001101110111000000100011
10000000W001  10001100000010001
100000000001111011010100100011
11000001110101011111011110011
11110111 1110101 101111010001
11111111 1111111 111111111111