
                 NO                    ./path_to_the_north_texture.png


                                        SO                                           ./path_to_the_south_texture.png
                                WE                                ./path_to_the_west_texture.png                        


                               EA                      ./path_to_the_east_texture.png

F           255,223,22               
					C      					    2,22,223
			
        11111111111
        10000000001
        10000000001
        1111111111111111111111111
        1000000000110000000000001
        1011000001110000000000001
        1001000000000000000000001
111111111011000001110000000000001
100000000011000001110111111111111
11110111111111011100000010001
11110111111110111010100100111
11000000110101011100000010001
10000000000000001100000010001
10000000000000001101010010001
11000001110101011111011110011
11110111 1110101 101111010001
11111111 1111111 111111111111