NO textures/no.png
SO textures/so.png
WE textures/we.png
EA textures/ea.png
F 40,40,40
C 135,206,235

1111111111111111111111111111111111111
1000000000000000000000000000000000001
1000000000000000000000000000000000001
10000000000000000000100000000000000001111111111111
10000000000000000000100000000000000000000000000001
10000000000S00000000100000000000000000000000000001
10000000000000000000100000000000000000000000000001
10000000000000000000100000000000000000000000000001
10000000011111100111111111111111100000000000000001
10000000000000000000000000000000000000000000000001
10000000000000000000000000000000000000000000000001
10000000000000000000000000000000000000000000000001
10000000000000000000000000000000000000000000000001
11111111111111111111111111111111111111111111111111
