                 NO                    ./path_to_the_north_texture.png


                                        SO                                           ./path_to_the_south_texture.png
                                WE                                ./path_to_the_west_texture.png                        


                               EA                      ./path_to_the_east_texture.png
F           255,223,22             
					C      					    2,22,223			

1111111111111111111111111
1000000000000000000000001
1000000000000000000000001
1000010000000000000000001
1000111000000000000000001
1000010000011111110000001
1000000000010000000000001
1000000000010000000000001
1000000000010000000000001
1000000000010000000000001
1000000000000000000000001
1000000000000000000000001
1000001100000000000000001
1000001100000000000000001
1000000000000000000000001
1000000000000000000000001
1000000000000000000000001
1000000000000000000000001
1111111111111111111111111