                 NO                    ./path_to_the_north_texture.png


                                        SO                                           ./path_to_the_south_texture.png
                                WE                                ./path_to_the_west_texture.png                        


                               EA                      ./path_to_the_east_texture.png
F           40,40,40             
					C      					    135,206,235			

1111111111111111111111111
1000000000000000000000001
1000000000000000000000001
1000010000000000000000001
1000111000000000000000001
1000010000011111110000001
1000010000010000000000001
1000000000010000000000001
1000000000010000000000001
1001110000010000000000001
10010100000000000W0000001
1001011100000000000000001
1001000000000000000000001
1001111000000000000000001
1001000000001000000000001
1000000000100000000000001
1000000000000000000000001
1000000000000000000000001
1111111111111111111111111