1111111111111111111111111
1000000000000000000000001
1000000000000000000000001
1000000000000000000000001
1000P00000000000000000001
1000000000011111110000001
1000000000010000000000001
1000000000010000000000001
1000000000010000000000001
1000000000010000000000001
1000000000000000000000001
1000000000000000000000001
1000001100000000000000001
1000001100000000000000001
1000000000000000000000001
1000000000000000000000001
1000000000000000000000001
1000000000000000000000001
1111111111111111111111111